6
7
####
# .#
#  ###
#*@  #
#  $ #
#    #
######