7
7
#######
#     #
#@$.# #
#*$  .#
# $$  #
# . . #
#######