7
7
#######
# @   #
#$* **#
#. #$ #
# . $ #
#  .  #
#######
